######################################################################################################
#             #   # #             # #                       # #                                   # ##
# # ######### # ### # ### ### ##### # ######### ##### ##### # # ######### # ### # ############# ### ##
# #         #           #   #                 #     # # # # # #         # #   # #             #     ##
# # # # ### ### ####### # ##### ##### ########### ##### # ### # ############### # ### # # # ##########
# # # #   #   #       # #     #     #       #   #     #           # #         # #   # # # # #       ##
### ### ### # # # # ############### ##### ### ######### ########### # ############# # # # # # ##### ##
#     #   # # # # #               #     #                                 #       # # # # #       # ##
# # # # ####### # # ##### ####### # # ### ######### # ### # # ### # # # ### ### ######### ### ##### ##
# # # #     #   # #     #       # # #   #         # #   # # #   # # # #   # # #         #   #     # ##
# # # # ### ####### # ### ####### ######### # ######### ######### ##### # # # ########### ##### ######
# # # #   #       # #   #       #         # #         #         #     # #               #     # # # ##
# # # ### ####### ### # # ### ####### ### ### # ### # # # ########### # ####### ### # # ####### # # ##
# # #   #       #   # # #   #       #   #   # #   # # # #           # #       #   # # #       # # # ##
# ### # ### ######### ### # # ### # ### # ##### ##### # ### ### # ####### # # # # ##### ### ##### # ##
#   # #   #         #   # # #   # #   # #     #   # # #   #   # #       # # # # #   # #   #         ##
# ### # ######### # # # # # # # ####### ####### ### ##### # # # # # # # ### # # ##### ################
#   # #         # # # # # # # #       #       #         # # # # # # # # # # # #             # #     ##
# ### ### ### # # ### # ### # ######### # ### ### # ### # # # ##### # ### ####### ### # ##### # ######
# #     #   # # # #   #   # #         # #   #   # #   # # # #     # #           #   # #     #       ##
# # # ### ############# ##### # # ### ### # # # ##### ##### # # ####### # ####### # ##### # # ### ####
# # #   #           # #     # # #   #   # # # #     #     # # #       # #       # #     # #     # # ##
# # # ########### # # # # ### # # # ####### ### ##### # # ### # ### ### ##### # ####### ##### # # # ##
# # # #         # #   # # #   # # #     #     #     # # #   # #   #   #     # #       #     # # # # ##
### # # ### ### ### ### # ##### # # # ##### # # # # ### ####### # ### # ### # ### # # ### # # # ### ##
#   #     #   #   #   # #     # # # #   #   # # # #   #     #   #   # #   # #   # # #   # # # #     ##
# # # ### ##### ############### # # ##### # # ### # ##### ##### # # # # ### # # # # ### # ### ### # ##
# # #   #     #               # # #     # # #   # #     #     # # # # #   # # # # #   # #   #   # # ##
### # # # ##### # ####### ####### # ### ### ####### ############# ### # ### # # ### # # # ### ### # ##
#   # # #     # #       #     # # #   # # #       #             # # # #   # # #   # # # #   #   # # ##
### # # # # # # # # # ### # ### ### # ### # # # ### ######### ##### ####### # ##### ##### ### ### # ##
#   # # # # # # # # #   # #       # #     # # # #           #             # #     # # # #   #   # # ##
### # # # # # ### ### ### ### # # ##### # # ####### # # ##### ### ################### # ### # ########
#   # # # # #   #   #   #   # # # #   # # #       # # #   # #   #           #             # #       ##
### ### # ### # ##### # ######### # ####### # # ### ####### ##### ########### ### # ### # ### # ######
#   #   #   # #     # #         #         # # #   #             #               # #   # #   # #   # ##
### ### # ######### ### # ### # # ### # ### ####### ### ### ################# # ### ### ##### # ### ##
#     # #         #   # #   # # #   # #   #   #   #   # # #                 # #   #   #     # #   # ##
### ##### # # ### # ######### ### ### ##### ### ######### ########### ### ### # ####### ########### ##
#   #     # #   # #         #   #   #     #           #             #   #   # # #   # # # # #       ##
# ##### # ##### ####### ######### # # # # ### # # ##### ### # ##### # ### ####### ### ### # # ########
# #     #     #       #   #   # # # # # #   # # #         # #     # #   #                           ##
# # # # # # ### ### # # ### ### ########### # ### ### # # ### ####### ########### ##### ####### ### ##
# # # # # #   #   # # #           #       # #   #   # # # # #       #   #       #     #       #   # ##
# ####### # # ### # ### # # ####### ##### ### ### # ##### # ### # ### # # ##### # # ##### # # # # # ##
# #       # #   # #   # # #             #   #   # #     #     # #   # #       # # #     # # # # # # ##
# ### ### # # # # # # ##### # # ############### # ####### # ### ### # # # # ### # # # # # ####### # ##
# #   #   # # # # # #   # # # #       #       # #       # #   #   # # # # #   # # # # # #       # # ##
# # ### # # # # ### ##### # ### ##### # ### ### ### # ### # # ########### # # # # # # ### ##### # # ##
# # #   # # # #   #       #   #     #     #   #   # #   # # #     # #   # # # # # # #   #     # # # ##
# # # # # # ####### ####### ### ##### # ##### ### # # # # ##### ### # ### # ##### # ##### # ### ### ##
# # # # # #     # # # #   #   #   #   #     #   # # # # #     #         # #     # #     # #   #   # ##
# # # # ### ### # ### # ##### # # ### ### # # ### ####### # ##### ################# ### # # # # # ####
# # # # #     #             # # #   #   # # #   #       # #     #                 #   # # # # # # # ##
# ### # # # # # # ######### # # ##### # # ### ######### # # ##### ### # # # ####### ### # # ### ### ##
# #   # # # # # #         # # #     # # #   #         # # #     #   # # # #       #   # # # # #     ##
##### # # # # # # # # # # ######### ### ####### # ##### # ### # # ### # ### # ##### ####### # ########
# #   # # # # # # # # # #         #   #       # #   # # #   # # #   # #   # #     #       #         ##
# ### ##### # # ### ### ### # # # ##### ############# # # # ##### # ################### ##### ########
#   # #   # # #   #   #   # # # #     #             # # # #     # # #           #     #     #       ##
### # ### # # # ##### # # ### # # ### # ######### ### ### # ####### # ########### ##### # ### # # # ##
#     #   # # # #   # # #   # # #   # #         #     #   #       #                   # #   # # # # ##
######### # ##### ####### # ### # # ########### # ######### # # # ####### # ####### # ### # # ### ####
#                       # #   # # #           # #         # # # #       # #       # #   # # #   # # ##
### # # ### # # # # ##### # # # # # # # ### # ##### # # ### # # ####### # ### # # ### # # ### ##### ##
#   # # #   # # # #     # # # # # # # #   # #     # # #   # # #       # #   # # #   # # # # # #     ##
### # # # # # # # # # # # # ##### # # # # # ##### ##### ### # # # ### ##### ##### # ##### # ### ######
#   # # # # # # # # # # # #     # # # # # #     #     #   # # # #   #     #     # #     # #         ##
####### # # ### ### ### ### ### # # # ### ### # # ### # # # ### # # ### # # ### ### ####### ##### ####
#       # #   #   #   #   # # # # # #   #   # # #   # # # # #   # #   # # #   #   #     #       # # ##
##### # ### # # # # # # ### # ### ### # ##### # # ####### # # # # # ### ### # # ### # ### ######### ##
#     # #   # # # # # #   #     #   # #     # # #       # # # # # #   #   # # # #   #               ##
##### # # # ### # # # # # # # # ### # ### ##### ### # ### ### ### # ### # ##### ### ####### ### # # ##
#     # # # #   # # # # # # # #   # #   #     #   # # #     # #   #   # #     #   #       #   # # # ##
####### ### ### ### # # # # ##### # # # # # ####### # # # ####### # # # # ##### ####### ### # # ######
#         # #     # # # # #     # # # # # #       # # # #       # # # # #     #       #   # # #     ##
# # # # ### # # ### # # # # ### ### # ################### ####### # # # # # ### ### # # ####### # # ##
# # # #   # # #   # # # # #   #   # # #               # #       # # # # # #   #   # # #     # # # # ##
### ### ### # # ### # ### # ### ##### # ##### ####### # # # # ### ### ### # # ### ### # ##### ### # ##
#   #   #   # #   # #   # # #       #       #       #   # # #   #   #   # # #   #   # #         # # ##
# # # # ### # # # # # ### # ### ### # # # # ####### ####### ##### # # ### ### # ####### # # ##### # ##
# # # # #   # # # # #   # # #     # # # # #       #       #     # # #   #   # #     #   # #     # # ##
### # ### # ### # # # # ### ### ### ### ### # # ##### ##### # ##### ### # ### # # # ### # # ### ### ##
#   # #   # #   # # # #   # #   #     #   # # #     #     # #     #   # #   # # # #   # # #   #   # ##
# # # ### # # # ### ####### ### # # # # # ################# # ##### # # # ####### # ### # # # ### # ##
# # #   # # # #   # #     #   # # # # # #                 # #     # # # #       # #   # # # #   # # ##
### # ### # # # ### # ######### ### # # ### ### # # # # # ### # # # ##### # # # # # ### # # # # ### ##
#   #   # # # # #           #     # # #   #   # # # # # #   # # # #     # # # # # #   # # # # #   # ##
# # # # # # ### ### ### ####### # ### # # ##### # ### ####### # # # ### # # # ### # ##### # ### # ####
# # # # # #   #   #   #       # #   # # #     # #   #       # # # #   # # # # #   #     # #   # #   ##
# # ### # # # # ### # # # # # # # ### # # # ### # # # ##### # ### # # # # # # ### # # # # # # # # ####
# # #   # # # # #   # # # # # # #   # # # # #   # # #     # #   # # # # # # #   # # # # # # # # #   ##
##### # ### ####### # # # ##### # # # ### ##### # # # # # ### # # ### # ### # # # # # ### # ### # ####
#     # #     #     # # #     # # # #   #     # # # # # #   # # #   # #   # # # # # #   # #   # #   ##
##### # ### # ### # ### # ### ### ####### # # # ### # ### # # # # # # ### ### ##### # # # # # # # ####
#     # #   # #   #   # #   # # #       # # # #   # #   # # # # # # #   #   #     # # # # # # # #   ##
### # # ### ### # # ### # ##### # # # ############# # ##### ### ### # # ### # ##### ##### ### # ######
#   # # # #   # # # #   #       # # #             # #   #     #   # # #   # #     #     # #   # # # ##
### # # # # ##### # ##### ##### ### # # ### ######### ##### ### # # # ######### # ####### ##### # # ##
#   # # #       # #     #     #   # # #   #         #     #   # # # #         # #     #       #    *##
######################################################################################################