######################################################################################################
#           #               # #         #             # #     #                   #         #     # ##
# # ######### ############### # ######### ##### ##### # # ### # ##### # ########### ### ### # ##### ##
# #       #                   # #     #       #     #       #       # #               #   #         ##
# # ####### ##### ####### ##### # ##### ####### # # # ### # ### ### # ### # # ####### # ########### ##
# #        x    #       # # #             #   # # # #   # #   #   # #   # # #       # #           # ##
# # ####### # # # ##### ### # ######### # # ########### ##### ####### # ### ######### ### # ### ### ##
# #       # # # #     #               # #             #     #       # #   #         #   # #   #   # ##
# # # # # ### ### # ################# # # ########### # # # # # # ########### # # ### # # ### # # # ##
# # # # #   #   # #                 # # #           # # # # # # #           # # #   # # #   # # # # ##
# # ### # ### ##### ########### ##### # ### # ### ####### # # ####### ####### # ##### ### # ##########
# # #   #   #     # # #       #     # #   # #   #       # # #       #       # #     #   # #         ##
# # ### # # # # # ### # ######### # ####### ### ####### # # # ### ### ### ### ### ### # ######### # ##
# #   # # # # # #               # #       #   #       # # # #   #   #   #   #   #   # #         # # ##
# # # ### # # ### # # # ####### # # ### ### ##### # # ####### ########### ### ####### ### # ##### ####
# # #   # # #   # # # #       # # # # #   #     # # #       #         # #   #     # # # # #     #   ##
# # # # # ### ### # # ### # ### ##### ##### # # ######### # # ### ##### ########### # # ### # ##### ##
# # # # # #     # # #   # #   # #         # # #         # # #   #                   #     # #     # ##
# # ##### ### # # ### # # # ##### ##### # # # ####### ######### # ##### # # ########### ##############
# #     # #   # #   # # # #           # # # #       #         # #     # # #     #     #           # ##
# ### # # ### # ####### # ##### ### ### ##### # # ##### ### ####### ##### # ##### ##### ########### ##
#   # # #   # #       # #     #   #   # #   # # #     #   #       #     # #           #   #   #   # ##
# # # # # ### # ####### # ### ##### ### # ##### ### ### ### ### ### # # # # # # ### ### ### ### ### ##
# # # # # #   #       # #   #     # # #       #   #   #   #   #   # # # # # # #   #   #   #         ##
# ##### ##### # ### # ##### # # # # # ### ##### # # ### ########### ####### ### # ######### ##########
#     #   # # #   # #     # # # # #     #     # # #   #           #       #   # #       # #         ##
# ##### ### # # # # # ##### ##### # # ########### ### ############### ######### ####### # # ##########
#     #     # # # # #     #     # # #           #   #               #   #   # #       # #         # ##
# # # # ### # # # ### # ##### ##### # # ########### ######### # ### ##### ### ########### ######### ##
# # # #   # # # #   # #     #     # # #           #         # #   #     #                           ##
# ### # # # # # # ### # ### # # ### ### # ##### ### # # # # # # # # # # # ########### # ##############
#   # # # # # # #   # #   # # #   #   # #     #   # # # # # # # # # # #             # #             ##
# ##### ##### # # # # # ### # # ##### # # # # ##### ########### # ### ### ##### ##### ##### ##########
#     #     # # # # # #   # # #     # # # # #     #           # # #     #     #     #     #         ##
# ##### ####### ##### ############# ######### ####### ##### # # # ### # # # # ##### ##################
#     #       # # #               # # #     #       #     # # # # #   # # # #     #               # ##
# ##### # ##### # ### # # ####### # # # ### ### ##### # ##### # # ### ####### ##### # # ########### ##
#     # #   #       # # #       # #       #   #     # #     # # # #         #     # # #         #   ##
# ### # # # ### # # # # # # ### ### # # ### # # # ### # # # ####### # # ##### # ####### # ### # # ####
#   # # # # #   # # # # # #   # # # # #   # # # #   # # # #     #   # #     # #       # #   # #     ##
# # ### # ### # # # # # ### # # # ### # ####### ### ####### ####### # # # ### # # ######### # # # ####
# #   # #   # # # # # #   # # #     # #       #   #       #       # # # #   # # #         # # # #   ##
# # # # # # # # # # ### ### # ### ### # ####### # # ### ####### ### # # # # # ##### ########### ######
# # # # # # # # # #   # #   #   #   # # #     # # #   #     # #   # # # # # #     #           #     ##
# ### ### ##### # # ####### ######### ### ##### # # ##### # # ######### ### # # # # ### # # ### ######
#   #   #     # # #     #           #         # # #     # #           #   # # # # #   # # #   #     ##
# # # # # # # ### # ##### # ### ####### # ##### ### ############# ######### ### ##### ################
# # # # # # #   # #     # #   #       # #     #   #   # #       #         #   #     #         # # # ##
# ####### # ### ### # ### # # ####### # # ############# # ############# # # ### ##### # ####### # # ##
#       # #   #   # #   # # #       # # #                             # # #   #     # #            *##
######################################################################################################